9
0 1 1 0 0 0 0 0 0 0 0
1 0 0 0 1 1 0 0 0 6000 0
1 0 0 1 1 0 0 0 0 3000 4000
0 0 1 0 0 0 1 0 1 3000 7000
0 1 1 0 0 1 1 0 0 6000 4000
0 1 0 0 1 0 0 0 0 9000 4000
0 0 0 1 1 0 0 1 1 6000 7000
0 0 0 0 0 0 1 0 1 9000 7000
0 0 0 1 0 0 1 1 0 6000 11000
